#,#,#,#,#,#,#,#
#,#,#,#,#,#,#,#
#,#,#,.,.,#,#,#
#,#,#, , ,#,#,#
#,#,#, , ,#,#,#
#,#,#,$,$,#,#,#
#,#,#, ,@,#,#,#
#,#,#,#,#,#,#,#
#,#,#,#,#,#,#,#

#,#,#,#,#,#,#,#
#,.,#,#,#,#,.,#
#, ,#,#,#,#, ,#
#, ,#,@, ,#,$,#
#, , ,$, , , ,#
#, ,#,#,#,#, ,#
#, , , , , , ,#
#, , , , , , ,#
#,#,#,#,#,#,#,#

#,#,#,#,#,#,#,#
#,.,#,#,#,#,#,#
#, ,#,#,#, , ,#
#, , , ,$, , ,#
#, ,@,#,#,#, ,#
#, , ,$, , , ,#
#, , ,#,#,#, ,#
#,#,#,#,#,#,.,#
#,#,#,#,#,#,#,#

#,#,#,#,#,#,#,#
#,#,#, , , ,#,#,#
#, ,$, ,#, ,#,#,#
#, ,#, , ,., ,#,#
#, , , , ,#, ,#,
#,#, ,#, , , ,#
#,#,@, , , ,#,#,#
#,#,#,#,#,#,#,#
#,#,#,#,#,#,#,#

#,#,#,#,#,#,#,#
#,#,#,#,#,#,#,#
#,#, , , , , ,#
#,#, ,.,$,., ,#
#,#, ,$,@,$, ,#
#, , ,.,$,., ,#
#, , , , , , ,#
#,#,#,#,#,#,#,#
#,#,#,#,#,#,#,#

#,#,#,#,#,#,#,#
#, , , ,#,#,#,#
#,., ,., , ,#,#
#, , , ,#, ,#,#
#,#, ,#, , ,#,#
#,#,@,$,$, ,#,#
#,#, , , , ,#,#
#,#, , ,#,#,#,#
#,#,#,#,#,#,#,#

#,#,#,#,#,#,#,#
#,#,#,#,#,.,#,#
#,#, ,$, , ,#,#
#,#,.,.,.,@,#,#
#,.,$,$,$,$,#,#
#,#,#, , , , ,#
#,#,#, , , , ,#
#,#,#,#,#,#,#,#
#,#,#,#,#,#,#,#

#,#,#,#,#,#,#,#
#,#,#, , , ,#,#
#,.,@,$, , ,#,#
#,#,#, ,$,.,#,#
#,.,#,#,$, ,#,#
#, ,#, ,., ,#,#
#,$, ,*,$,$,.,#
#, , , ,., , ,#
#,#,#,#,#,#,#,#

#,#,#,#,#,#,#,#
#,#,#,#,#,#,#,#
#,., ,., ,.,#,#
#, ,$,$,$, ,#,#
#,.,$,@,$,.,#,#
#, ,$,$,$, ,#,#
#,., ,., ,.,#,#
#,#,#,#,#,#,#,#
#,#,#,#,#,#,#,#

#,#,#,#,#,#,#,#
#,#,#, , , ,#,#
#, , , , , ,#,#
#, , ,#,.,#,#,#
#,#,@,$,$,$, ,#
#,#,.,#,.,#, ,#
#,#, , , , , ,#
#,#, , ,#,#,#,#
#,#,#,#,#,#,#,#

#,#,#,#,#,#,#,#
#,#, , ,#,#,#,#
#,#, , , , , ,#
#,#, ,#,., , ,#
#,#,*,#,#,$,#,#
#, , , , , , ,#
#, ,#, ,@, , ,#
#, , , , ,#,#,#
#,#,#,#,#,#,#,#

#,#,#,#,#,#,#,#
#, , , ,#,#,#,#
#, , , , , ,#,#
#,#, , , , ,#,#
#,#,#,#,$,#,#,#
#, , ,$, ,#,#,#
#, ,@, , , ,#,#
#,#,#,., ,.,#,#
#,#,#,#,#,#,#,#

#,#,#,#,#,#,#,#
#,#, , , ,#,#,#
#,#,$,#, ,#,#,#
#, , , ,$,@, ,#
#, ,#, , ,#, ,#
#, ,#,., ,., ,#
#, , , ,#,#,#,#
#,#,#,#,#,#,#,#
#,#,#,#,#,#,#,#

#,#,#,#,#,#,#,#
#,#,#,#,#, , ,#
#, , , ,*, , ,#
#, ,*,.,#, , ,#
#,#, ,#,#, ,#,#
#, ,$, , , , ,#
#, ,@,#, , , ,#
#, , ,#,#,#,#,#
#,#,#,#,#,#,#,#

#,#,#,#,#,#,#,#
#,#, , , ,#,#,#
#,#, ,#,$, ,@,#
#, ,., ,$, , ,#
#,.,.,.,#,$,#,#
#, ,#, , ,$, ,#
#, , ,#, , , ,#
#,#, , , ,#,#,#
#,#,#,#,#,#,#,#